5
+--+--+--+--+--+
   |  |        |
+  +  +  +--+--+
|              |
+  +--+  +--+  +
|  |     |  |  |
+  +--+  +  +--+
|  |     |     |
+--+  +--+  +  +
|           |   
+--+--+--+--+--+
